WWWWWWWWWWWWWWWWWWWWWWWWWWWWWWWWWWWWWWWW
W                                      W
W  GGGG  G     G   G   GGGGG           W
W  G     G     G   G   G               W
W  G GG  G     GGGGG   GGG             W
W  G  G  G     G   G   G               W
W  GGGG  GGGG  G   G   G               W
W                                      W
WWWWWWWWWWWWWWWWWWWWWWWWWWWWW          W
W                                      W
W T                                    W
W                                      W
WWWWWWWWWWWWWWWWWWWWWWWWWWWWWWWWWWWWWWWW