WWWWWWWWWWWWWWWWWWWWWWWWWWWWWWWWWWWWWWWWWWWWWWWWWWWWWWWWWW
W                                                        W
T                                                        T
T                                                        T
T                                                        T
T             G                                          T
T             G                                          T
T             G                                          T
T                                                        T
T                                                        T
T                                                        T
W                                                        W
WWWWWWWWWWWWWWWWWWWWWWWWWWWWWWWWWWWWWWWWWWWWWWWWWWWWWWWWWW