WWWWWWWWWWWWWWWWWWWWWWWWWWWWWWWWWWWWWWWWWWWWW
W                                           W
W                              WW           W
W     G    W                                W
W                                           W
W                   TTT            G        W
W       W           TWT                     W
W                   TTT                     W
W                             W             W
W              WW                           W
W        G     WW                    W      W
W                                           W
WWWWWWWWWWWWWWWWWWWWWWWWWWWWWWWWWWWWWWWWWWWWW