WWWWWWWWWWWWWWWWWWWWWWWWWWWWWWWWWWWWWWWWWWWWWWWWWWWWWWWWWW
W                                                        W
W                                                        W
W                                                        W
W                          W                             W
W             G            WT                            W
W             G            WT                            W
W             G            WT                            W
W                          W                             W
W                                                        W
W                                                        W
W                                                        W
WWWWWWWWWWWWWWWWWWWWWWWWWWWWWWWWWWWWWWWWWWWWWWWWWWWWWWWWWW